NO ./textures/n.png
SO ./textures/n.png
WE ./textures/n.png
EA ./textures/n.png

C 10, 50, 100
F 0, 50, 50


        1111111111111111111111111
        1000000000010000000000001
        10110000011010000N0000001
        1001000000000000000000001
111111111011000001110000000000001
100000000011000001110111111111111
11110111111111011100000010001
11110111111111011101010010001
11000000110101011100000010001
10000000000000000000000000001
10000000000000001101010010001
1100000111010101111101111000111
11110111 1110101 1011110100011
11111111 1111111 111111111111