NO ./textures/path_to_the_north_texture
SO ./textures/path_to_the_south_texture
WE ./textures/path_to_the_west_texture
EA ./textures/path_to_the_east_texture

C 1,2,3
F 225,30,255



         11111111111 11111111111111
         10000000001 10000000000001
         1011000000111000000000001
         1001000000000000000000001
111111111111000001110000011111111
100000000011000001110111111111111
11110111111111011100000010001
11110111111111011101010010001
11000000110101011100000010001
100000000000000011000000000011
1111111000000000001101000010001
11000001110101011111011110E011
11110111 1110101 101111010001
11111111 1111111 111111111111