NO ./textures/1.png
SO ./textures/2.png
WE ./textures/3.png
EA ./textures/4.png

C 10, 50, 100
F 0, 50, 50


    1111111111111111111111111
    1000000000000000000000001
    10110000000S000000000001
    1001000000000000000111111
11111111101100000111001
10000000001100000111011
11110111111111011100001
11110111111111011101011
11000000110101011100001
1111111111111111111111111