NO ./textures/n.png
SO ./textures/n.png
WE ./textures/n.png
EA ./textures/n.png

C 10, 50, 100
F 0, 50, 50


    1111111111111111111111111
    1000000000010000000000001
    10110000011010000N0000001
    1001000000000000000111111
11111111101100000111001
10000000001100000111011
11110111111111011100001
11110111111111011101011
11000000110101011100001
11111111111111111111111